6 8
11111104
10300001
10101001
10005101
13101031
11111111
