6 9
111101111
100210031
200000001
100000010
150010041
111101111
