9 10
1111111111
1200000031
1010001001
1001010001
1005140011
1101010101
1010001001
1000000001
1111111111
