8 8
10101011
01210141
10000001
10050010
01021001
10000001
14101021
11010111
