6 6
112111
520011
101001
110011
101001
111411
