7 9
112111111
100000251
010000010
100000001
120000101
013101431
101010111
