5 7
1111111
1201031
1101011
1401051
1111111
