7 9
111111111
141200131
100101001
100001001
111110001
150000101
111111111
